 16  15  14  13  12  11  10   9   9   9   9   9 
 16  15  14  13  12  11  10   9   8   8   8   8 
 16  15  14   1   1   1   1   1   1   7   7   7 
 16  15  15   1   1   1   1   1   1   6   6   7 
 16  16  16  16   0   1   3   3   4   5   6   7 
  0   0   0   0   0   1   2   3   4   5   6   7 
